Operation=op
To=to
From=from
Identifier=rqi
resourceType=rty
Content=pc
OriginatingTimestamp=ot
RequestExpirationTimestamp=rqet
ResultExpirationTimestamp=rset
OperationExecutionTime=oet
ResponseType=rt
labels=lbl
ResultPersistence=rp
accessControlPolicyIDs=acpi
announcedAttribute=aa
announceTo=at
creationTime=ct
expirationTime=et
lastModifiedTime=lt
parentID=pi
resourceID=ri
stateTag=st
name=rn
privileges=pv
selfPrivileges=pvs
appID=api
aeid=aei
appName=apn
pointOfAccess=poa
ontologyRef=or
nodeLink=nl
creator=cr
maxNrOfInstances=mni
maxByteSize=mbs
maxInstanceAge=mia
currentNrOfInstances=cni
currentByteSize=cbs
latest=la
oldest=ol
locationID=li
contentInfo=cnf
contentSize=cs
content=con
cseType=cst
cseid=csi
supportedResourceType=srt
notificationCongestionPolicy=ncp
source=sr
target=tg
lifespan=ls
eventCat=ec
deliveryMetaData=dmd
aggregatedRequest=arq
aggregatedRequest=evi
eventType=evt
evenStart=evs
eventEnd=eve
operationType=opt
dataSize=ds
execStatus=exs
execResult=exr
execDisable=exd
execTarget=ext
execMode=exm
execFrequency=exf
execDelay=exy
execNumber=exn
execReqArgs=exra
execEnable=exe
memberType=mt
currentNrOfMembers=cnm
maxNrOfMembers=mnm
memberID=mid
membersAccessControlPolicyIDs=macp
memberTypeValidated=mtv
consistencyStrategy=csy
groupName=gn
locationSource=los
locationUpdatePeriod=lou
locationTargetId=lot
locationServer=lor
locationContainerID=loi
locationContainerName=lon
locationStatus=lost
serviceRoles=svr
description=dc
cmdType=cmt
mgmtDefinition=mgd
objectIDs=obis
objectPaths=obps
nodeID=ni
hostedCSELink=hcl
csebase=cb
m2MExtID=mei
triggerRecipientID=tri
requestReachability=rr
originator=og
metaInformation=mi
requestStatus=rs
operationResult=ol
operation=opn
requestID=rid
scheduleElement=se
deviceIdentifier=di
statsCollectID=sci
collectingEntityID=cei
collectedEntityID=cdi
status=ss
statsRuleStatus=srs
statModel=sm
collectPeriod=sp
eventNotificationCriteria=enc
expirationCounter=exc
notificationURI=nu
notificationForwardingURI=nfu
batchNotify=bn
rateLimit=rl
preSubscriptionNotify=psn
pendingNotification=pn
notificationStoragePriority=nsp
latestNotify=ln
notificationContentType=nct
notificationEventCat=nec
subscriberURI=su
version=vr
url=url
update=ud
updateStatus=uds
install=in
uninstall=un
installStatus=ins
activate=act
deactivate=dea
activateStatus=acts
memAvailable=mma
memTotal=mmt
areaNwkType=ant
listOfDevices=ldv
devId=dvd
devType=dvt
areaNwkId=awi
sleepInterval=sli
sleepDuration=sld
listOfNeighbors=lnh
batteryLevel=btl
batteryStatus=bts
deviceLabel=dlb
manufacturer=man
model=mod
deviceType=dty
fwVersion=fwv
swVersion=swv
hwVersion=hwv
capabilityName=can
attached=att
capabilityActionStatus=cas
enable=ena
disable=dis
currentState=cus
reboot=rbo
factoryReset=far
logTypeId=lgt
logData=lgd
logActionStatus=lgs
logStart=lga
logStop=lgo
mgmtLink=cmlk
order=od
defEcValue=dev
requestOrigin=ror
requestContext=rct
requestContextNotification=rcn
requestCharacteristics=rch
applicableEventCategories=aecs
applicableEventCategory=aec
defaultRequestExpTime=dqet
defaultResultExpTime=dset
defaultOpExecTime=doet
defaultRespPersistence=drp
defaultDelAggregation=dda
limitsEventCategory=lec
limitsRequestExpTime=lqet
limitsResultExpTime=lset
limitsOpExecTime=loet
limitsRespPersistence=lrp
limitsDelAggregation=lda
targetNetwork=ttn
minReqVolume=mrv
backOffParameters=bop
otherConditions=ohc
maxBufferSize=mbfs
storagePriority=sgp
applicableCredIDs=aci
allowedApp-IDs=aai
allowedAEs=aae
childResource=ch
groupID=gpi
accessControlRule=acr
accessControlOriginators=acor
accessControlOperations=acop
accessControlContexts=acco
accessControlWindow=actw
accessControlIpAddresses=acip
ipv4Addresses=ipv4
ipv6Addresses=ipv6
accessControlLocationRegion=aclr
countryCode=accc
circRegion=accr
createdBefore=crb
operationMonitor=om
modifiedSince=ms
notificationEvent=nev
representation=rep
operation=op
originator=org
verificationRequest=vrq
subscriptionDeletion=sud
subscriptionReference=sur
notificationForwardingURI=nfu
createdAfter=cra
unmodifiedSince=us
stateTagSmaller=sts
stateTagBigger=stb
expireBefore=exb
expireAfter=exa
sizeAbove=sza
sizeBelow=szb
attribute=atr
resourceStatus=net
AE=m2m:ae
AccessControlPolicy=m2m:acp
Container=m2m:cnt
ContentInstance=m2m:cin
CSEBase=m2m:cb
ExecInstance=m2m:exin
Group=m2m:grp
LocationPolicy=m2m:lcp
MgmtCmd=m2m:mgc
Node=m2m:nod
PollingChannel=m2m:pch
RemoteCSE=m2m:csr
Request=m2m:req
Subscription=m2m:sub
Notification=m2m:sgn
Software=m2m:swr
Firmware=m2m:fwr
DeviceInfo=m2m:dvi
Reboot=m2m:rbo
Memory=m2m:mem
Battery=m2m:bat
DeviceCapability=m2m:dvc
EventLog=m2m:evl
AreaNwkInfo=m2m:ani
AreaNwkDeviceInfo=m2m:andi